111111111111111111111111
100P00000000000P00000001
100P000000000C0P00000001
100010001000011100000001
10001000100010001000C001
10001CCC1000000C10000001
100001111000001100000001
100000001000010000000001
100000001PPP1C0000000001
1000C0001000111110000001
100000000000000000000E11
111111111111111111111111