
NO s

WE       ./rsrc/ananas.xpm
EA ./rsrc/ricardo.xpm
SO        ./rsrc/coconut.xpm
F 200    , 150,       50
C    100,    00000000000000000000000000000000000000000100,   100




1111111111
1001000001
1111000001
100N000001
100000000111
10000   00001
1111111 1111111
      1 1   
111111   11
1         1
1        1
1    1111    11
1        111111
111111111111111




